1111111111111111111
1333333331333333331
1311011101011101131
1011011101011101101
1000000000000000001
1011010011100101101
1000010001000100001
1111011101011101111
1111010000000101111
1111010110110101111
0000000102010000000
1111010111110101111
1111010000000101111
1111010011100101111
1000010001000100001
1011011101011101101
1001000000000001001
1101010011100101011
1000010001000100001
1011111101011111101
1000000000000000001
1111111111111111111
