111111111111111111111111
1000000000000010000000001
1010111110111110111110101
1000100000100010100000101
1010101110101110101110101
1000100000000000000000101
1010111110111110111110101
1000000000100010000000001
1111111110101110111111111
0000000010000000100000000
1111111110111110111111111
1000000000000010000000001
1010111111111111111110101
1000100010000010000100101
1010101110101110101110101
1000000000100010000000001
1111111110111110111111111
0000000010000000100000000
1111111110111110111111111
1000000000100010000000001
1010111110111110111110101
1000100000100010100000101
1010101110101110101110101
1000100000000000000000101
1010111110111110111110101
1000000000000010000000001
1111111111111111111111111
