1111111111111111111
1000000000000000001
1011111101111111101
1011111101111111101
1000000000000000001
1011110111111011101
1000010000100010001
1110111110111110111
1110111110111110111
1000000000000000001
1110111111111011101
1110111111111011101
1000010000100010001
1011111101111111101
1000000000000000001
1111111111111111111
